포트무게는 어떻게 되?	포트 무게는 <WGT> 입니다.
포트무게는 어떻게 되?	포트 무게는 <WGT> 입니다.
포트 무게가 얼마야?	포트 무게는 <WGT> 입니다.
포트는 얼마나 무거워?	포트 무게는 <WGT> 입니다.
포트 중량이 얼마야	포트 무게는 <WGT> 입니다.
포트 무게는 어떻게 될까?	포트 무게는 <WGT> 입니다.
포트 무게 알려줘	포트 무게는 <WGT> 입니다.
포트 무게 좀 알려줘	포트 무게는 <WGT> 입니다.
이 전기 포트 무게 알려줘	포트 무게는 <WGT> 입니다.
포트 무게 얼마야?	포트 무게는 <WGT> 입니다.
포트 중량 알려줘	포트 무게는 <WGT> 입니다.
포트 중량이 어떻게 되?	포트 무게는 <WGT> 입니다.
중량은?	포트 무게는 <WGT> 입니다.
포트 중량?	포트 무게는 <WGT> 입니다.
포트 중량은?	포트 무게는 <WGT> 입니다.
무게?	포트 무게는 <WGT> 입니다.
포트 무게는?	포트 무게는 <WGT> 입니다.
포트 무게 알려줘	포트 무게는 <WGT> 입니다.
포트 무게?	포트 무게는 <WGT> 입니다.
중량?	포트 무게는 <WGT> 입니다.
포트 중량 알고 싶어	포트 무게는 <WGT> 입니다.
포트 중량이 어떻게 될까?	포트 무게는 <WGT> 입니다.
이 전기 포트 중량 알고 싶어	포트 무게는 <WGT> 입니다.
이 전기 포트 중량 알려줘	포트 무게는 <WGT> 입니다.
전기 포트 중량 알고 싶어	포트 무게는 <WGT> 입니다.
전기 포트 무게 알려줘	포트 무게는 <WGT> 입니다.
전기 포트 무게 어떻게 될까?	포트 무게는 <WGT> 입니다.
전기 포트 무게 알고 싶어	포트 무게는 <WGT> 입니다.
포트용량이 어떻게 되?	포트 용량은 <VOL> 입니다.
포트 용량이 얼마야?	포트 용량은 <VOL> 입니다.
포트에 물이 얼마나 들어가?	포트 용량은 <VOL> 입니다.
포트에 물을 얼마나 넣을 수 있어?	포트 용량은 <VOL> 입니다.
포트에 물 얼마나 들어가?	포트 용량은 <VOL> 입니다.
포트에 물을 얼마나 넣을 수 있을까?	포트 용량은 <VOL> 입니다.
포트에 물이 몇 리터 들어가?	포트 용량은 <VOL> 입니다.
포트용량이 몇 리터야?	포트 용량은 <VOL> 입니다.
포트 용량이 얼마야?	포트 용량은 <VOL> 입니다.
용량이 얼마야	포트 용량은 <VOL> 입니다.
용량이 어떻게 되?	포트 용량은 <VOL> 입니다.
물이 얼마나 들어가?	포트 용량은 <VOL> 입니다.
물을 얼마나 넣을 수 있어?	포트 용량은 <VOL> 입니다.
물 얼마나 들어갈 수 있을까?	포트 용량은 <VOL> 입니다.
포트에 물이 얼마나 들어갈 수 있을까?	포트 용량은 <VOL> 입니다.
포트에 물이 몇 리터 들어가?	포트 용량은 <VOL> 입니다.
용량이 몇 리터야?	포트 용량은 <VOL> 입니다.
물을 얼마나 넣을 수 있을까?	포트 용량은 <VOL> 입니다.
용량은?	포트 용량은 <VOL> 입니다.
이 전기 포트 용량이 몇 리터야?	포트 용량은 <VOL> 입니다.
이 전기 포트 용량이 얼마야?	포트 용량은 <VOL> 입니다.
이 전기 포트 용량은?	포트 용량은 <VOL> 입니다.
전기 포트에 물이 얼마나 들어가?	포트 용량은 <VOL> 입니다.
전기 포트에 물 얼마나 넣을 수 있어?	포트 용량은 <VOL> 입니다.
포트 용량 알려줘	포트 용량은 <VOL> 입니다.
이 전기 포트 용량 알려줘	포트 용량은 <VOL> 입니다.
이 포트 용량 알려줘	포트 용량은 <VOL> 입니다.
이 포트 용량 알고 싶어	포트 용량은 <VOL> 입니다.
최대 가열온도가 얼마야?	포트 최대 가열 온도는 <TMP> 입니다.
가열 온도가 어떻게 되?	포트 최대 가열 온도는 <TMP> 입니다.
가열 온도는?	포트 최대 가열 온도는 <TMP> 입니다.
가열온도가 얼마야?	포트 최대 가열 온도는 <TMP> 입니다.
가열 온도는 얼마야	포트 최대 가열 온도는 <TMP> 입니다.
가열 온도는 높아?	포트 최대 가열 온도는 <TMP> 입니다.
몇 도까지 가열이 가능해?	포트 최대 가열 온도는 <TMP> 입니다.
몇 도까지 가열할 수 있어?	포트 최대 가열 온도는 <TMP> 입니다.
이 전기 포트 최대 가열 온도가 얼마야	포트 최대 가열 온도는 <TMP> 입니다.
이 전기 포트 최대 가열 온도는?	포트 최대 가열 온도는 <TMP> 입니다.
이 전기 포트 몇 도까지 가열 할 수 있어?	포트 최대 가열 온도는 <TMP> 입니다.
이 포트 몇 도까지 가열 가능해?	포트 최대 가열 온도는 <TMP> 입니다.
전기 포트 몇 도까지 가열 가능해?	포트 최대 가열 온도는 <TMP> 입니다.
전기 포트 가열 온도 얼마야?	포트 최대 가열 온도는 <TMP> 입니다.
포트에 최대 가열 온도가 얼마야	포트 최대 가열 온도는 <TMP> 입니다.
이 전기 포트에 몇도까지 가열 가능해?	포트 최대 가열 온도는 <TMP> 입니다.
포트에 가열 온도는 높아?	포트 최대 가열 온도는 <TMP> 입니다.
포트 가열 온도는 높아?	포트 최대 가열 온도는 <TMP> 입니다.
포트 가열 온도는 얼마야	포트 최대 가열 온도는 <TMP> 입니다.
이 포트 최대 가열온도는?	포트 최대 가열 온도는 <TMP> 입니다.
이 포트 몇 도까지 가열 할 수 있어?	포트 최대 가열 온도는 <TMP> 입니다.
이 전기 포트 가열 온도 알려줘	포트 최대 가열 온도는 <TMP> 입니다.
이 전기포트 가열 온도 얼마야	포트 최대 가열 온도는 <TMP> 입니다.
포트 가열 온도 알려줘	포트 최대 가열 온도는 <TMP> 입니다.
포트 가열 온도 알고 싶어	포트 최대 가열 온도는 <TMP> 입니다.
가열 온도 알고 싶어	포트 최대 가열 온도는 <TMP> 입니다.
가열 온도 알려줘	포트 최대 가열 온도는 <TMP> 입니다.
시간 조절할 수 있어?	시간 조절이 <TIM> 합니다.
시간 조절이 가능해?	시간 조절이 <TIM> 합니다.
시간 조절 기능이 있어?	시간 조절이 <TIM> 합니다.
시간 조절은 어떻게 해야해?	시간 조절이 <TIM> 합니다.
시간 기능 있어?	시간 조절이 <TIM> 합니다.
시간 조절 기능 있어?	시간 조절이 <TIM> 합니다.
시간 조절 어떻게 해?	시간 조절이 <TIM> 합니다.
시간 조절 가능해?	시간 조절이 <TIM> 합니다.
시간 기능 가능해?	시간 조절이 <TIM> 합니다.
보온 시간 기능 있어?	시간 조절이 <TIM> 합니다.
보온 시간은 어떻게 작동해?	시간 조절이 <TIM> 합니다.
보온 시간 기능은 어떻게 사용해?	시간 조절이 <TIM> 합니다.
보온 시간은?	시간 조절이 <TIM> 합니다.
시간 기능은?	시간 조절이 <TIM> 합니다.
시간 조절 기능?	시간 조절이 <TIM> 합니다.
이 전기포트 시간 조절이 가능해?	시간 조절이 <TIM> 합니다.
이 전기 포트 시간 기능 있어?	시간 조절이 <TIM> 합니다.
이 전기 포트 시간 조절 어떻게 해?	시간 조절이 <TIM> 합니다.
이 전기 포트 시간 기능 가능해?	시간 조절이 <TIM> 합니다.
전기 포트는 보온 시간 기능 있어?	시간 조절이 <TIM> 합니다.
전기 포트 시간 기능 있어?	시간 조절이 <TIM> 합니다.
전기 포트 시간 조절 기능은?	시간 조절이 <TIM> 합니다.
포트 시간 기능은?	시간 조절이 <TIM> 합니다.
포트 보온 시간 기능 있어?	시간 조절이 <TIM> 합니다.
포트에 보온 시간 기능 있어?	시간 조절이 <TIM> 합니다.
포트에 시간 기능은?	시간 조절이 <TIM> 합니다.
포트에 시간 기능 있어?	시간 조절이 <TIM> 합니다.
포트에 시간 조절이 가능해?	시간 조절이 <TIM> 합니다.
포트에 시간 조절은 어떻게 해야해?	시간 조절이 <TIM> 합니다.
시간 조절 법 알려줘	시간 조절이 <TIM> 합니다.
이 포트 시간 조절 어떻게 해?	시간 조절이 <TIM> 합니다.
이 포트 시간 조절하는 법 알려줘	시간 조절이 <TIM> 합니다.
포트 시간 조절 법 알려줘	시간 조절이 <TIM> 합니다.
포트 시간 조절 법 알고 싶어	시간 조절이 <TIM> 합니다.
소재는 어떻게 되?	소재는 <MTR> 가 사용 됩니다.
소재는 뭐야?	소재는 <MTR> 가 사용 됩니다.
소재가 어떻게 되?	소재는 <MTR> 가 사용 됩니다.
이거 소재가 뭐야?	소재는 <MTR> 가 사용 됩니다.
포트 소재가 어떻게 되?	소재는 <MTR> 가 사용 됩니다.
이 포트 소재는 뭘로 만들었어?	소재는 <MTR> 가 사용 됩니다.
포트는 뭐로 만들었어?	소재는 <MTR> 가 사용 됩니다.
포트 소재가 뭐야	소재는 <MTR> 가 사용 됩니다.
포트 소재는 어떻게 되?	소재는 <MTR> 가 사용 됩니다.
포트 소재는?	소재는 <MTR> 가 사용 됩니다.
포트 소재는 뭐야	소재는 <MTR> 가 사용 됩니다.
소재는?	소재는 <MTR> 가 사용 됩니다.
소재?	소재는 <MTR> 가 사용 됩니다.
소재가 뭐야	소재는 <MTR> 가 사용 됩니다.
포트 소재가 뭐야	소재는 <MTR> 가 사용 됩니다.
포트 소재?	소재는 <MTR> 가 사용 됩니다.
이 포트 소재는 무엇으로 만들었어?	소재는 <MTR> 가 사용 됩니다.
이 전기포트 소재는 뭐야?	소재는 <MTR> 가 사용 됩니다.
이 전기포트 소재는 어떻게 되?	소재는 <MTR> 가 사용 됩니다.
이 전기포트 소재는 뭐지?	소재는 <MTR> 가 사용 됩니다.
전기 포트 소재 알려줘	소재는 <MTR> 가 사용 됩니다.
전기 포트 소재는?	소재는 <MTR> 가 사용 됩니다.
포트 소재 알려줘	소재는 <MTR> 가 사용 됩니다.
소재 알려줘	소재는 <MTR> 가 사용 됩니다.
소재 알고 싶어	소재는 <MTR> 가 사용 됩니다.
제품 크기는 어떻게 되?	제품 크기는 <SIZ> 입니다.
포트 크기는 얼마야	제품 크기는 <SIZ> 입니다.
포트 크기는?	제품 크기는 <SIZ> 입니다.
제품 크기는?	제품 크기는 <SIZ> 입니다.
이 전기 포트 얼마나 커?	제품 크기는 <SIZ> 입니다.
이 포트 얼마나 커?	제품 크기는 <SIZ> 입니다.
제품 사이즈가 얼마야?	제품 크기는 <SIZ> 입니다.
포트 사이즈가 얼마야	제품 크기는 <SIZ> 입니다.
포트 사이즈 알려줘	제품 크기는 <SIZ> 입니다.
이 포트 사이즈 얼마야	제품 크기는 <SIZ> 입니다.
이 전기포트 크기는?	제품 크기는 <SIZ> 입니다.
이 전기포트 사이즈는?	제품 크기는 <SIZ> 입니다.
이 포트 사이즈는 얼마나 커?	제품 크기는 <SIZ> 입니다.
포트 사이즈는?	제품 크기는 <SIZ> 입니다.
포트 사이즈는 어떻게 되?	제품 크기는 <SIZ> 입니다.
이 전기 포트 사이즈는 어떻게 되	제품 크기는 <SIZ> 입니다.
이 전기포트 크기는 얼마야	제품 크기는 <SIZ> 입니다.
이 전기포트 크기는 어떻게 되	제품 크기는 <SIZ> 입니다.
포트 크기 알려줘	제품 크기는 <SIZ> 입니다.
이 전기 포트 사이즈 알려줘	제품 크기는 <SIZ> 입니다.
전기 포트 사이즈 알고 싶어	제품 크기는 <SIZ> 입니다.
포트 사이즈 알고 싶어	제품 크기는 <SIZ> 입니다.
포트 크기 알고 싶어	제품 크기는 <SIZ> 입니다.
이 전기 포트 크기 알려줘	제품 크기는 <SIZ> 입니다.
보온 온도 설정 가능해?	네 보온 온도 설정이 가능합니다.
온도 설정할 수 있어?	네 보온 온도 설정이 가능합니다.
온도 설정이 가능해?	네 보온 온도 설정이 가능합니다.
보온 가능해?	네 보온 온도 설정이 가능합니다.
보온이 가능해?	네 보온 온도 설정이 가능합니다.
보온은 가능해?	네 보온 온도 설정이 가능합니다.
보온 온도 설정이 가능해?	네 보온 온도 설정이 가능합니다.
보온 온도 설정은 가능해?	네 보온 온도 설정이 가능합니다.
이 포트는 보온 설정 가능해?	네 보온 온도 설정이 가능합니다.
이 포트 보온 온도 설정할 수 있어?	네 보온 온도 설정이 가능합니다.
이 포트는 보온 온도 설정이 가능해?	네 보온 온도 설정이 가능합니다.
보온 온도 설정 기능이 있어?	네 보온 온도 설정이 가능합니다.
보온 온도 설정 할 수 있어?	네 보온 온도 설정이 가능합니다.
온도 설정 기능이 있어?	네 보온 온도 설정이 가능합니다.
보온 기능 있어?	네 보온 온도 설정이 가능합니다.
보온 기능은 사용 가능해?	네 보온 온도 설정이 가능합니다.
보온 기능 사용할 수 있어?	네 보온 온도 설정이 가능합니다.
보온 사용할 수 있어?	네 보온 온도 설정이 가능합니다.
보온 기능은?	네 보온 온도 설정이 가능합니다.
보온?	네 보온 온도 설정이 가능합니다.
이 전기 포트 보온 설정 할 수 있어?	네 보온 온도 설정이 가능합니다.
전기 포트 보온 설정 가능해?	네 보온 온도 설정이 가능합니다.
이 전기 포트 보온 기능 있어?	네 보온 온도 설정이 가능합니다.
이 전기 포트에 보온 기능 있어?	네 보온 온도 설정이 가능합니다.
보온 온도는 몇 도까지 가능해?	온도 설정 버튼으로 디지털부에 나타나는 원하는 온도를 설정하여 물을 끓이거나 데울 수 있습니다. 설정 온도 도달 시 삐삐삐 소리와 함께 가열이 중단 됩니다. 온도는 100c 까지 가능합니다.
보온 온도 설정은 몇 도까지 할 수 있어?	온도 설정 버튼으로 디지털부에 나타나는 원하는 온도를 설정하여 물을 끓이거나 데울 수 있습니다. 설정 온도 도달 시 삐삐삐 소리와 함께 가열이 중단 됩니다. 온도는 100c 까지 가능합니다.
보온 온도 설정은 몇 도 단위까지 할 수 있어?	온도 설정 버튼으로 디지털부에 나타나는 원하는 온도를 설정하여 물을 끓이거나 데울 수 있습니다. 설정 온도 도달 시 삐삐삐 소리와 함께 가열이 중단 됩니다. 온도는 100c 까지 가능합니다.
온도 설정은 몇 도까지 가능해?	온도 설정 버튼으로 디지털부에 나타나는 원하는 온도를 설정하여 물을 끓이거나 데울 수 있습니다. 설정 온도 도달 시 삐삐삐 소리와 함께 가열이 중단 됩니다. 온도는 100c 까지 가능합니다.
온도 설정은 어떻게 해?	온도 설정 버튼으로 디지털부에 나타나는 원하는 온도를 설정하여 물을 끓이거나 데울 수 있습니다. 설정 온도 도달 시 삐삐삐 소리와 함께 가열이 중단 됩니다. 온도는 100c 까지 가능합니다.
온도 설정 어떻게 해?	온도 설정 버튼으로 디지털부에 나타나는 원하는 온도를 설정하여 물을 끓이거나 데울 수 있습니다. 설정 온도 도달 시 삐삐삐 소리와 함께 가열이 중단 됩니다. 온도는 100c 까지 가능합니다.
온도 설정 기능은 어떻게 사용해?	온도 설정 버튼으로 디지털부에 나타나는 원하는 온도를 설정하여 물을 끓이거나 데울 수 있습니다. 설정 온도 도달 시 삐삐삐 소리와 함께 가열이 중단 됩니다. 온도는 100c 까지 가능합니다.
보온 온도 기능은 어떻게 사용해?	온도 설정 버튼으로 디지털부에 나타나는 원하는 온도를 설정하여 물을 끓이거나 데울 수 있습니다. 설정 온도 도달 시 삐삐삐 소리와 함께 가열이 중단 됩니다. 온도는 100c 까지 가능합니다.
보온 기능은 어떻게 사용해?	온도 설정 버튼으로 디지털부에 나타나는 원하는 온도를 설정하여 물을 끓이거나 데울 수 있습니다. 설정 온도 도달 시 삐삐삐 소리와 함께 가열이 중단 됩니다. 온도는 100c 까지 가능합니다.
보온 기능 사용법이 뭐야	온도 설정 버튼으로 디지털부에 나타나는 원하는 온도를 설정하여 물을 끓이거나 데울 수 있습니다. 설정 온도 도달 시 삐삐삐 소리와 함께 가열이 중단 됩니다. 온도는 100c 까지 가능합니다.
이 전기 포트에 온도 기능은 어떻게 사용해?	온도 설정 버튼으로 디지털부에 나타나는 원하는 온도를 설정하여 물을 끓이거나 데울 수 있습니다. 설정 온도 도달 시 삐삐삐 소리와 함께 가열이 중단 됩니다. 온도는 100c 까지 가능합니다.
포트에 보온 온도는 몇 도까지 가능해?	온도 설정 버튼으로 디지털부에 나타나는 원하는 온도를 설정하여 물을 끓이거나 데울 수 있습니다. 설정 온도 도달 시 삐삐삐 소리와 함께 가열이 중단 됩니다. 온도는 100c 까지 가능합니다.
포트에 온도 설정 어떻게 해?	온도 설정 버튼으로 디지털부에 나타나는 원하는 온도를 설정하여 물을 끓이거나 데울 수 있습니다. 설정 온도 도달 시 삐삐삐 소리와 함께 가열이 중단 됩니다. 온도는 100c 까지 가능합니다.
보온 온도 설정 알려줘	온도 설정 버튼으로 디지털부에 나타나는 원하는 온도를 설정하여 물을 끓이거나 데울 수 있습니다. 설정 온도 도달 시 삐삐삐 소리와 함께 가열이 중단 됩니다. 온도는 100c 까지 가능합니다.
이 전기포트 보온 기능 알려줘	온도 설정 버튼으로 디지털부에 나타나는 원하는 온도를 설정하여 물을 끓이거나 데울 수 있습니다. 설정 온도 도달 시 삐삐삐 소리와 함께 가열이 중단 됩니다. 온도는 100c 까지 가능합니다.
이 포트 보온 기능 알고 싶어	온도 설정 버튼으로 디지털부에 나타나는 원하는 온도를 설정하여 물을 끓이거나 데울 수 있습니다. 설정 온도 도달 시 삐삐삐 소리와 함께 가열이 중단 됩니다. 온도는 100c 까지 가능합니다.
이 전기 포트 보온 설정 하는 법 알려줘봐	온도 설정 버튼으로 디지털부에 나타나는 원하는 온도를 설정하여 물을 끓이거나 데울 수 있습니다. 설정 온도 도달 시 삐삐삐 소리와 함께 가열이 중단 됩니다. 온도는 100c 까지 가능합니다.
이 전기 포트 보온 설정 어떤 방식으로 해?	온도 설정 버튼으로 디지털부에 나타나는 원하는 온도를 설정하여 물을 끓이거나 데울 수 있습니다. 설정 온도 도달 시 삐삐삐 소리와 함께 가열이 중단 됩니다. 온도는 100c 까지 가능합니다.
어떤 방식으로 이 전기 포트 보온 설정 할 수 있어?	온도 설정 버튼으로 디지털부에 나타나는 원하는 온도를 설정하여 물을 끓이거나 데울 수 있습니다. 설정 온도 도달 시 삐삐삐 소리와 함께 가열이 중단 됩니다. 온도는 100c 까지 가능합니다.
어떻게 보온 설정 할 수 있어?	온도 설정 버튼으로 디지털부에 나타나는 원하는 온도를 설정하여 물을 끓이거나 데울 수 있습니다. 설정 온도 도달 시 삐삐삐 소리와 함께 가열이 중단 됩니다. 온도는 100c 까지 가능합니다.
어떤 방식으로 보온 설정이 가능해?	온도 설정 버튼으로 디지털부에 나타나는 원하는 온도를 설정하여 물을 끓이거나 데울 수 있습니다. 설정 온도 도달 시 삐삐삐 소리와 함께 가열이 중단 됩니다. 온도는 100c 까지 가능합니다.
전기 포트 보온 설정하는 방식 알려줘	온도 설정 버튼으로 디지털부에 나타나는 원하는 온도를 설정하여 물을 끓이거나 데울 수 있습니다. 설정 온도 도달 시 삐삐삐 소리와 함께 가열이 중단 됩니다. 온도는 100c 까지 가능합니다.
전기 포트 보온 설정 알려줄 수 있어?	온도 설정 버튼으로 디지털부에 나타나는 원하는 온도를 설정하여 물을 끓이거나 데울 수 있습니다. 설정 온도 도달 시 삐삐삐 소리와 함께 가열이 중단 됩니다. 온도는 100c 까지 가능합니다.
이 전기포트는 보온 설정 어떻게 해?	온도 설정 버튼으로 디지털부에 나타나는 원하는 온도를 설정하여 물을 끓이거나 데울 수 있습니다. 설정 온도 도달 시 삐삐삐 소리와 함께 가열이 중단 됩니다. 온도는 100c 까지 가능합니다.
이 전기 포트는 보온 설정을 어떻게 할 수 있어?	온도 설정 버튼으로 디지털부에 나타나는 원하는 온도를 설정하여 물을 끓이거나 데울 수 있습니다. 설정 온도 도달 시 삐삐삐 소리와 함께 가열이 중단 됩니다. 온도는 100c 까지 가능합니다.
이 전기 포트 보온 설정 방식 알려줘	온도 설정 버튼으로 디지털부에 나타나는 원하는 온도를 설정하여 물을 끓이거나 데울 수 있습니다. 설정 온도 도달 시 삐삐삐 소리와 함께 가열이 중단 됩니다. 온도는 100c 까지 가능합니다.
보온 설정 방식 알고 싶어	온도 설정 버튼으로 디지털부에 나타나는 원하는 온도를 설정하여 물을 끓이거나 데울 수 있습니다. 설정 온도 도달 시 삐삐삐 소리와 함께 가열이 중단 됩니다. 온도는 100c 까지 가능합니다.
어떤식으로 보온 설정 할 수 있어?	온도 설정 버튼으로 디지털부에 나타나는 원하는 온도를 설정하여 물을 끓이거나 데울 수 있습니다. 설정 온도 도달 시 삐삐삐 소리와 함께 가열이 중단 됩니다. 온도는 100c 까지 가능합니다.
어떤식으로 이 포트 보온 설정해?	온도 설정 버튼으로 디지털부에 나타나는 원하는 온도를 설정하여 물을 끓이거나 데울 수 있습니다. 설정 온도 도달 시 삐삐삐 소리와 함께 가열이 중단 됩니다. 온도는 100c 까지 가능합니다.
이 전기 포트 어떤방식으로 보온 설정해?	온도 설정 버튼으로 디지털부에 나타나는 원하는 온도를 설정하여 물을 끓이거나 데울 수 있습니다. 설정 온도 도달 시 삐삐삐 소리와 함께 가열이 중단 됩니다. 온도는 100c 까지 가능합니다.
이 전기 포트 온도 설정 어떻게 해?	온도 설정 버튼으로 디지털부에 나타나는 원하는 온도를 설정하여 물을 끓이거나 데울 수 있습니다. 설정 온도 도달 시 삐삐삐 소리와 함께 가열이 중단 됩니다. 온도는 100c 까지 가능합니다.
이 전기 포트는 어떤 방식으로 온도 설정할 수 있어?	온도 설정 버튼으로 디지털부에 나타나는 원하는 온도를 설정하여 물을 끓이거나 데울 수 있습니다. 설정 온도 도달 시 삐삐삐 소리와 함께 가열이 중단 됩니다. 온도는 100c 까지 가능합니다.
이 전기 포트 온도 설정 방식을 알려주세요	온도 설정 버튼으로 디지털부에 나타나는 원하는 온도를 설정하여 물을 끓이거나 데울 수 있습니다. 설정 온도 도달 시 삐삐삐 소리와 함께 가열이 중단 됩니다. 온도는 100c 까지 가능합니다.
