포트무게는 어떻게 되?	ANS1
포트무게는 어떻게 되?	ANS1
포트 무게가 얼마야?	ANS1
포트는 얼마나 무거워?	ANS1
포트 중량이 얼마야	ANS1
포트 무게는 어떻게 될까?	ANS1
포트 무게 알려줘	ANS1
포트 무게 좀 알려줘	ANS1
이 전기 포트 무게 알려줘	ANS1
포트 무게 얼마야?	ANS1
포트 중량 알려줘	ANS1
포트 중량이 어떻게 되?	ANS1
중량은?	ANS1
포트 중량?	ANS1
포트 중량은?	ANS1
무게?	ANS1
포트 무게는?	ANS1
포트 무게 알려줘	ANS1
포트 무게?	ANS1
중량?	ANS1
포트 중량 알고 싶어	ANS1
포트 중량이 어떻게 될까?	ANS1
이 전기 포트 중량 알고 싶어	ANS1
이 전기 포트 중량 알려줘	ANS1
전기 포트 중량 알고 싶어	ANS1
전기 포트 무게 알려줘	ANS1
전기 포트 무게 어떻게 될까?	ANS1
전기 포트 무게 알고 싶어	ANS1
포트용량이 어떻게 되?	ANS2
포트 용량이 얼마야?	ANS2
포트에 물이 얼마나 들어가?	ANS2
포트에 물을 얼마나 넣을 수 있어?	ANS2
포트에 물 얼마나 들어가?	ANS2
포트에 물을 얼마나 넣을 수 있을까?	ANS2
포트에 물이 몇 리터 들어가?	ANS2
포트용량이 몇 리터야?	ANS2
포트 용량이 얼마야?	ANS2
용량이 얼마야	ANS2
용량이 어떻게 되?	ANS2
물이 얼마나 들어가?	ANS2
물을 얼마나 넣을 수 있어?	ANS2
물 얼마나 들어갈 수 있을까?	ANS2
포트에 물이 얼마나 들어갈 수 있을까?	ANS2
포트에 물이 몇 리터 들어가?	ANS2
용량이 몇 리터야?	ANS2
물을 얼마나 넣을 수 있을까?	ANS2
용량은?	ANS2
이 전기 포트 용량이 몇 리터야?	ANS2
이 전기 포트 용량이 얼마야?	ANS2
이 전기 포트 용량은?	ANS2
전기 포트에 물이 얼마나 들어가?	ANS2
전기 포트에 물 얼마나 넣을 수 있어?	ANS2
포트 용량 알려줘	ANS2
이 전기 포트 용량 알려줘	ANS2
이 포트 용량 알려줘	ANS2
이 포트 용량 알고 싶어	ANS2
최대 가열온도가 얼마야?	ANS3
가열 온도가 어떻게 되?	ANS3
가열 온도는?	ANS3
가열온도가 얼마야?	ANS3
가열 온도는 얼마야	ANS3
가열 온도는 높아?	ANS3
몇 도까지 가열이 가능해?	ANS3
몇 도까지 가열할 수 있어?	ANS3
이 전기 포트 최대 가열 온도가 얼마야	ANS3
이 전기 포트 최대 가열 온도는?	ANS3
이 전기 포트 몇 도까지 가열 할 수 있어?	ANS3
이 포트 몇 도까지 가열 가능해?	ANS3
전기 포트 몇 도까지 가열 가능해?	ANS3
전기 포트 가열 온도 얼마야?	ANS3
포트에 최대 가열 온도가 얼마야	ANS3
이 전기 포트에 몇도까지 가열 가능해?	ANS3
포트에 가열 온도는 높아?	ANS3
포트 가열 온도는 높아?	ANS3
포트 가열 온도는 얼마야	ANS3
이 포트 최대 가열온도는?	ANS3
이 포트 몇 도까지 가열 할 수 있어?	ANS3
이 전기 포트 가열 온도 알려줘	ANS3
이 전기포트 가열 온도 얼마야	ANS3
포트 가열 온도 알려줘	ANS3
포트 가열 온도 알고 싶어	ANS3
가열 온도 알고 싶어	ANS3
가열 온도 알려줘	ANS3
시간 조절할 수 있어?	ANS4
시간 조절이 가능해?	ANS4
시간 조절 기능이 있어?	ANS4
시간 조절은 어떻게 해야해?	ANS4
시간 기능 있어?	ANS4
시간 조절 기능 있어?	ANS4
시간 조절 어떻게 해?	ANS4
시간 조절 가능해?	ANS4
시간 기능 가능해?	ANS4
보온 시간 기능 있어?	ANS4
보온 시간은 어떻게 작동해?	ANS4
보온 시간 기능은 어떻게 사용해?	ANS4
보온 시간은?	ANS4
시간 기능은?	ANS4
시간 조절 기능?	ANS4
이 전기포트 시간 조절이 가능해?	ANS4
이 전기 포트 시간 기능 있어?	ANS4
이 전기 포트 시간 조절 어떻게 해?	ANS4
이 전기 포트 시간 기능 가능해?	ANS4
전기 포트는 보온 시간 기능 있어?	ANS4
전기 포트 시간 기능 있어?	ANS4
전기 포트 시간 조절 기능은?	ANS4
포트 시간 기능은?	ANS4
포트 보온 시간 기능 있어?	ANS4
포트에 보온 시간 기능 있어?	ANS4
포트에 시간 기능은?	ANS4
포트에 시간 기능 있어?	ANS4
포트에 시간 조절이 가능해?	ANS4
포트에 시간 조절은 어떻게 해야해?	ANS4
시간 조절 법 알려줘	ANS4
이 포트 시간 조절 어떻게 해?	ANS4
이 포트 시간 조절하는 법 알려줘	ANS4
포트 시간 조절 법 알려줘	ANS4
포트 시간 조절 법 알고 싶어	ANS4
소재는 어떻게 되?	ANS5
소재는 뭐야?	ANS5
소재가 어떻게 되?	ANS5
이거 소재가 뭐야?	ANS5
포트 소재가 어떻게 되?	ANS5
이 포트 소재는 뭘로 만들었어?	ANS5
포트는 뭐로 만들었어?	ANS5
포트 소재가 뭐야	ANS5
포트 소재는 어떻게 되?	ANS5
포트 소재는?	ANS5
포트 소재는 뭐야	ANS5
소재는?	ANS5
소재?	ANS5
소재가 뭐야	ANS5
포트 소재가 뭐야	ANS5
포트 소재?	ANS5
이 포트 소재는 무엇으로 만들었어?	ANS5
이 전기포트 소재는 뭐야?	ANS5
이 전기포트 소재는 어떻게 되?	ANS5
이 전기포트 소재는 뭐지?	ANS5
전기 포트 소재 알려줘	ANS5
전기 포트 소재는?	ANS5
포트 소재 알려줘	ANS5
소재 알려줘	ANS5
소재 알고 싶어	ANS5
제품 크기는 어떻게 되?	ANS6
포트 크기는 얼마야	ANS6
포트 크기는?	ANS6
제품 크기는?	ANS6
이 전기 포트 얼마나 커?	ANS6
이 포트 얼마나 커?	ANS6
제품 사이즈가 얼마야?	ANS6
포트 사이즈가 얼마야	ANS6
포트 사이즈 알려줘	ANS6
이 포트 사이즈 얼마야	ANS6
이 전기포트 크기는?	ANS6
이 전기포트 사이즈는?	ANS6
이 포트 사이즈는 얼마나 커?	ANS6
포트 사이즈는?	ANS6
포트 사이즈는 어떻게 되?	ANS6
이 전기 포트 사이즈는 어떻게 되	ANS6
이 전기포트 크기는 얼마야	ANS6
이 전기포트 크기는 어떻게 되	ANS6
포트 크기 알려줘	ANS6
이 전기 포트 사이즈 알려줘	ANS6
전기 포트 사이즈 알고 싶어	ANS6
포트 사이즈 알고 싶어	ANS6
포트 크기 알고 싶어	ANS6
이 전기 포트 크기 알려줘	ANS6
보온 온도 설정 가능해?	ANS7
온도 설정할 수 있어?	ANS7
온도 설정이 가능해?	ANS7
보온 가능해?	ANS7
보온이 가능해?	ANS7
보온은 가능해?	ANS7
보온 온도 설정이 가능해?	ANS7
보온 온도 설정은 가능해?	ANS7
이 포트는 보온 설정 가능해?	ANS7
이 포트 보온 온도 설정할 수 있어?	ANS7
이 포트는 보온 온도 설정이 가능해?	ANS7
보온 온도 설정 기능이 있어?	ANS7
보온 온도 설정 할 수 있어?	ANS7
온도 설정 기능이 있어?	ANS7
보온 기능 있어?	ANS7
보온 기능은 사용 가능해?	ANS7
보온 기능 사용할 수 있어?	ANS7
보온 사용할 수 있어?	ANS7
보온 기능은?	ANS7
보온?	ANS7
이 전기 포트 보온 설정 할 수 있어?	ANS7
전기 포트 보온 설정 가능해?	ANS7
이 전기 포트 보온 기능 있어?	ANS7
이 전기 포트에 보온 기능 있어?	ANS7
보온 온도는 몇 도까지 가능해?	ANS8
보온 온도 설정은 몇 도까지 할 수 있어?	ANS8
보온 온도 설정은 몇 도 단위까지 할 수 있어?	ANS8
온도 설정은 몇 도까지 가능해?	ANS8
온도 설정은 어떻게 해?	ANS8
온도 설정 어떻게 해?	ANS8
온도 설정 기능은 어떻게 사용해?	ANS8
보온 온도 기능은 어떻게 사용해?	ANS8
보온 기능은 어떻게 사용해?	ANS8
보온 기능 사용법이 뭐야	ANS8
이 전기 포트에 온도 기능은 어떻게 사용해?	ANS8
포트에 보온 온도는 몇 도까지 가능해?	ANS8
포트에 온도 설정 어떻게 해?	ANS8
보온 온도 설정 알려줘	ANS8
이 전기포트 보온 기능 알려줘	ANS8
이 포트 보온 기능 알고 싶어	ANS8
이 전기 포트 보온 설정 하는 법 알려줘봐	ANS8
이 전기 포트 보온 설정 어떤 방식으로 해?	ANS8
어떤 방식으로 이 전기 포트 보온 설정 할 수 있어?	ANS8
어떻게 보온 설정 할 수 있어?	ANS8
어떤 방식으로 보온 설정이 가능해?	ANS8
전기 포트 보온 설정하는 방식 알려줘	ANS8
전기 포트 보온 설정 알려줄 수 있어?	ANS8
이 전기포트는 보온 설정 어떻게 해?	ANS8
이 전기 포트는 보온 설정을 어떻게 할 수 있어?	ANS8
이 전기 포트 보온 설정 방식 알려줘	ANS8
보온 설정 방식 알고 싶어	ANS8
어떤식으로 보온 설정 할 수 있어?	ANS8
어떤식으로 이 포트 보온 설정해?	ANS8
이 전기 포트 어떤방식으로 보온 설정해?	ANS8
이 전기 포트 온도 설정 어떻게 해?	ANS8
이 전기 포트는 어떤 방식으로 온도 설정할 수 있어?	ANS8
전력사용량이 얼마야?	ANS9
소비전력 알려줘	ANS9
소비전력이 알고 싶어	ANS9
소비전력이 얼마일까?	ANS9
이 전기 포트 소비 전력 알려줘	ANS9
이 커피 포트 소비 전력 알려줘	ANS9
커피 포트 소비 전력 알려줘	ANS9
이 포트 소비 전력 알려줘	ANS9
이거 소비 전력 알려줘	ANS9
이 전기 포트 전력 사용량이 얼마야	ANS9
이 포트 전력 사용량 알려줘	ANS9
이 포트 전력 사용 알려줘	ANS9
이 커피 포트 전력 사용량이 궁금해	ANS9
이 커피 포트 전력 사용량 알 수 있을까?	ANS9
이 전기 포트 전력 사용량 알 수 있을까?	ANS9
이 포트 전력 사용량이 궁금해	ANS9
이 포트 전력 사용량 알고 싶어	ANS9
이 전기포트 전기 소비 알고 싶어	ANS9
이 커피 포트 전기 소비 얼마야	ANS9
이 커피 포트 전기 소비 알 수 있어?	ANS9
이 포트 전기 소비 사용 궁금해	ANS9
이 포트 전기 소비량이 얼마야	ANS9
이 전기 포트 전기 사용량 알고 싶어	ANS9
이 전기 포트 전기 사용량 궁금해	ANS9
전기 포트 전기 사용량 알고 싶어	ANS9
커피 포트 전기 소비량 알려줘	ANS9
포트 전기 소비량 알려줘	ANS9
전기 소비량 알려줘	ANS9
전력 소비량 알고 싶어	ANS9
소비 전력 알고 싶어	ANS9
소비 전력 알려줘	ANS9
전기 소비 알려줘	ANS9
전력 소비 알려줘	ANS9
전력 소비 궁금해	ANS9
전기 소비 궁금해	ANS9
전기 소비에 대해 알려줘	ANS9
전력 소비에 대해 궁금해	ANS9
전력 사용량에 대해 알려줘	ANS9
전력 사용량에 대해 궁금해	ANS9
색상은 어떻게 되?	ANS10
색상은 뭐야?	ANS10
색상이 어떻게 되?	ANS10
이거 색상이 뭐야?	ANS10
포트 색상이 어떻게 되?	ANS10
이 포트 색상에 대해 알려줘	ANS10
포트 색상은 어떤게 있어?	ANS10
포트 색상이 뭐야	ANS10
포트 색상은 어떻게 되?	ANS10
포트 색상은?	ANS10
포트 색상은 뭐야	ANS10
색상은?	ANS10
색상?	ANS10
색상이 뭐야	ANS10
포트 색상이 뭐야	ANS10
포트 색상?	ANS10
이 포트 색상은 무엇으로 만들었어?	ANS10
이 전기포트 색상은 뭐야?	ANS10
이 전기포트 색상은 어떻게 되?	ANS10
이 전기포트 색상은 뭐지?	ANS10
전기 포트 색상 알려줘	ANS10
전기 포트 색상은?	ANS10
포트 색상 알려줘	ANS10
색상 알려줘	ANS10
색상 알고 싶어	ANS10
이 커피포트 색상 알려줘	ANS10
이 커피포트 색상에 대해 궁금해	ANS10
커피 포트 색상에 대해 알려줘	ANS10
커피 포트 색상 알려줘	ANS10
커피 포트 색상은 뭘로 만들었어?	ANS10
커피 포트 색상 검색	ANS10
커피 포트 색상은 무엇이 가능해?	ANS10
커피 포트 색상은 뭐뭐가 있어?	ANS10
커피 포트 색상은 뭐가 있어?	ANS10
포트 색상은 뭐가 있어?	ANS10
전기 포트 색상은 뭐가 있어?	ANS10
이 포트 색상은 뭐가 있어?	ANS10
포트 색상은 뭐 있어?	ANS10
전기 포트 색상은 뭐 있어?	ANS10
안녕	COM1
안녕하세요	COM1
하이	COM1
반가워요	COM1
방가	COM1
굿모닝	COM1
헬로	COM1
배송 정보 알려줘	COM2
배송 상태 알려줘	COM2
이거 배송 상태 알려줘	COM2
이거 배송 정보 알려줘	COM2
이거 배송이 궁금해	COM2
배송에 대해 알려줘	COM2
배송이 궁금해	COM2
배송 상태 궁금해	COM2
배송 상태 알고 싶어	COM2
배송 알고 싶어	COM2
배송	COM2
배송 정보 알고 싶어	COM2
배송 정보에 대해 알고 싶어	COM2
배송 정보에 대해 궁금해	COM2
배송이 언제될까?	COM2
배송은 언제되?	COM2
상품은 언제 도착해?	COM2
상품 도착일이 언제야?	COM2
상품 배송 궁금해	COM2
상품 배송 상태 알려줘	COM2
상품 배송일에 대해 알려줘	COM2
상품 배송은 언제 되?	COM2
상품 배송에 대해 알고 싶어	COM2
상품 배송 정보 알려줘	COM2
상품 배송 상태 알려줘	COM2
상품 배송 정보에 대해 알 수 있을까?	COM2
상품 배송 정보 알 수 있을까?	COM2
상품 배송 정보 알려줄 수 있어?	COM2
상품 배송 정보 에 대해 알고 싶어	COM2
상품 배송은 언제 가능해?	COM2
할인정보 알려줘	COM3
할인이 뭐가 되?	COM3
이거 할인 되?	COM3
세일해?	COM3
세일 정보 알려줘	COM3
할인하는지 궁금해	COM3
가격 할인해?	COM3
가격 할인 정보 알려줘	COM3
가격 할인 정보 궁금해	COM3
가격 할인 알고 싶어	COM3
할인 정보 궁금해	COM3
할인 알고 싶어	COM3
할인 정보 알 수 있을까?	COM3
할인 정보 알 수 있어?	COM3
할인 정보는 뭐야	COM3
할인 정보가 알고 싶어	COM3
할인에 대해 알 수 있을까?	COM3
할인에 대해 알고 싶어	COM3
할인에 대해 알려줘	COM3
가격 할인에 대해 알려줘	COM3
가격 할인에 대해 알고 싶어	COM3
가격 할인에 대해 알려줄 수 있어?	COM3
가격 알려줘	COM4
가격이 궁금해	COM4
이거 얼마야?	COM4
가격 정보 알려줘	COM4
가격 정보 궁금해	COM4
가격이 얼마일까?	COM4
가격이 얼마인지 알 수 있어?	COM4
가격을 알 수 있을까?	COM4
얼마인지 알 수 있을까?	COM4
얼마야?	COM4
얼마인지 궁금해	COM4
얼마나 할까?	COM4
이거 얼마나 할까?	COM4
가격 정보 알려줘	COM4
가격 정보 알 수 있어?	COM4
가격 정보가 궁금해	COM4
가격이 얼마인지 알려줘	COM4
가격을 알고 싶어	COM4
가격	COM4
얼마면 살 수 있어?	COM4
이거 얼마야?	COM4
얼마야?	COM4
가격에 대해 알려줘	COM4
이거 가격에 대해 알려줘	COM4
가격에 대해 알고 싶어	COM4
가격에 대해 알려줄 수 있어?	COM4
배송비 얼마야?	COM5
배송비에 대해 알려줘	COM5
배송비는 얼마야?	COM5
배송비 있어?	COM5
배송비 포함이야?	COM5
배송비는 얼마나 들어?	COM5
배송비가 있어?	COM5
배송비는 있어?	COM5
배송비에 대해 알려줘	COM5
배송비에 대해 알고 싶어	COM5
배송비 정보 알려줘	COM5
배송비가 궁금해	COM5
배송비 알려줄 수 있어?	COM5
배송비가 얼마나 들까?	COM5
배송비 얼마나 들까?	COM5
배송비 비싸?	COM5
배송비 없어?	COM5
배송비가 있는지 궁금해	COM5
배송비가 있을까?	COM5
배송하는데 얼마나 들어?	COM5
배송하는데 얼마나 들까?	COM5
배송에 얼마나 들어?	COM5
배송 비용이 얼마야?	COM5
배송 비용에 대해 알려줘	COM5
배송 비용이 궁금해	COM5
배송 비용 알려줄 수 있어?	COM5
배송 비용 얼마나 들어?	COM5
배송 비용 포함이야?	COM5
배송 비용 있어?	COM5
배송비용 얼마야?	COM5
배송비용 궁금해	COM5
배송 비용 비싸?	COM5
배송 비용 없어?	COM5
배송 비용은 얼마나 들까?	COM5
배송 비용은 얼마나 들어?	COM5
AS에 대해 알려줘	COM6
AS 전화번호 있어?	COM6
AS는 어떻게 되?	COM6
AS는 어떻게 되?	COM6
수리는 어떻게 해?	COM6
AS센터 전화번호 알려줘	COM6
AS 센터 어디로 연락해?	COM6
AS 연락처 알려줘	COM6
AS 센터 연락처는 뭐야	COM6
AS 연락처 알고 싶어	COM6
AS 연락처는 뭐야?	COM6
AS 알려줘	COM6
AS 전화번호 알려줘	COM6
AS 전화번호 알고 싶어	COM6
AS 번호 알려줘	COM6
AS 번호는 뭐야	COM6
AS 번호가 뭐야	COM6
AS 전번 알려줘	COM6
AS 전번은 뭐야	COM6
AS 전번 알고 싶어	COM6
AS 전번 연락처 알려줘	COM6
수리 전화번호 알려줘	COM6
수리 번호 알려줘	COM6
수리 전번 알고 싶어	COM6
수리 번호 알고 싶어	COM6
수리 전화번호 알려줘	COM6
수리 전화번호 알고 싶어	COM6
수리 전화번호 알려줘	COM6
고장수리 전화 번호 알려줘	COM6
고장 수리 전화번호는 뭐야	COM6
고장 수리 전번은 뭐야	COM6
고장수리 전번 알려줘	COM6
고장 수리 전번 알고 싶어	COM6
고장 수리는 어디로 연락해?	COM6
고장 수리 연락처 알려줘	COM6
고장 수리 전번 알려줘	COM6
AS는 어디로 연락해?	COM6
고장수리에 대해 알려줘	COM6
수리에 대해 알려줘	COM6
수리 방법 알려줘	COM6
고장 수리 방법 알려줘	COM6
고장 수리 방법 알고 싶어	COM6
수리 방법 알고싶어	COM6
AS 정보 알려줘	COM6
고장 수리 정보 알려줘	COM6
수리 정보 알려줘	COM6
수리 정보에 대해 알고 싶어	COM6
수리 정보에 대해 알려줘	COM6
수리 정보는 뭐야	COM6
고장 수리 정보 알려줘	COM6
AS 센터 정보 알려줘	COM6
AS 정보 알려줘	COM6
AS 센터에 대해 알려줘	COM6
AS 센터 전화번호 알려줘	COM6
AS 센터 전화 번호 정보 알려줘	COM6
