동일 용량의 같은 브랜드 찾아줘	SRC1
같은 용량의 동일 브랜드 검색해줘	SRC1
이거랑 같은 용량 같은 브랜드 검색해줘	SRC1
이 상품이랑 같은 브랜드의 같은 용량 검색해줘	SRC1
이 상품이랑 동일 브랜드의 동일 용량 상품 검색해줘	SRC1
동일 브랜드 동일 용량 상품 찾아줘	SRC1
동일 브랜드 용량 상품 검색해줘	SRC1
같은 브랜드 용량 찾아줘	SRC1
동일 브랜드 용량 찾아줘	SRC1
같은 브랜드 용량 검색해줘	SRC1
동일 브랜드 용량 상품 찾아줘	SRC1
동일 브랜드 용량이지만 다른 개수의 상품 찾아줘	SRC1
다른 개수 동일 브랜드 같은 용량 상품 찾아줘	SRC1
다른 개수이지만 동일 브랜드의 동일 용량의 상품 찾아줘	SRC1
다른 개수이고 같은 브랜드의 같은 용량의 상품을 찾아줘	SRC1
같은 브랜드 다른 개수 동일 용량의 상품 찾아줘	SRC1
개수가 다르지만 같은 브랜드 용량 상품 찾아줘	SRC1
개수가 다르지만 동일 브랜드 용량 상품 검색해줘	SRC1
개수가 다르지만 동일 브랜드 용량 상품은 뭐야?	SRC1
동일 브랜드에 같은 용량이지만 개수가 다른 상품은 뭐야	SRC1
동일 브랜드 동일 용량이지만 다른 개수의 상품은 뭐야	SRC1
동일 브랜드와 동일 용량의 상품은 뭐야	SRC1
동일 브랜드와 동일 용량의 상품은 뭐가 있지?	SRC1
같은 브랜드와 같은 용량의 상품은 뭐가 있지?	SRC1
이것과 같은 브랜드에 같은 용량이지만 다른 개수의 상품은 뭐가 있지?	SRC1
다른 개수의 상품은 뭐가 있어?	SRC1
개수만 다른 상품은 뭐야?	SRC1
다른 조건은 동일하지만 개수만 다른 상품은 뭐가 있어?	SRC1
개수가 다른 상품 검색해줘	SRC1
개수만 다른 상품 찾아줘	SRC1
개수만 다른 상품 검색해줘	SRC1
다 동일하지만 개수만 다른 상품은?	SRC1
모두 동일하지만 개수만 다른 상품은 뭐가 있어?	SRC1
모두 동일하지만 개수만 다른 상품은 뭐야?	SRC1
모두 동일하지만 개수만 다른 상품 찾아줘	SRC1
동일하지만 개수만 다른 상품 찾아줘	SRC1
개수가 다른 상품은 뭐가 있어?	SRC1
동일 브랜드 동일 용량이지만 개수만 다른 상품은 뭐야?	SRC1
개수만 다른 상품이 뭔지 궁금해	SRC1
개수가 다르지만 같은 브랜드의 같은 용량의 상품을 검색해줘	SRC1
동일 용량의 같은 개수의 찾아줘	SRC2
같은 용량의 동일 개수 검색해줘	SRC2
이거랑 같은 용량 같은 개수 검색해줘	SRC2
이 상품이랑 같은 개수의 같은 용량 검색해줘	SRC2
이 상품이랑 동일 개수의 동일 용량 상품 검색해줘	SRC2
동일 개수 동일 용량 상품 찾아줘	SRC2
동일 개수 용량 상품 검색해줘	SRC2
같은 개수 용량 찾아줘	SRC2
동일 개수 용량 찾아줘	SRC2
같은 개수 용량 검색해줘	SRC2
동일 개수 용량 상품 찾아줘	SRC2
동일 개수 용량이지만 다른 브랜드의 상품 찾아줘	SRC2
다른 브랜드 동일 개수 같은 용량 상품 찾아줘	SRC2
다른 브랜드이지만 동일 개수의 동일 용량의 상품 찾아줘	SRC2
다른 브랜드이고 같은 개수의 같은 용량의 상품을 찾아줘	SRC2
같은 개수 다른 브랜드 동일 용량의 상품 찾아줘	SRC2
브랜드가 다르지만 같은 개수 용량 상품 찾아줘	SRC2
브랜드가 다르지만 동일 개수 용량 상품 검색해줘	SRC2
브랜드가 다르지만 동일 개수 용량 상품은 뭐야?	SRC2
동일 개수에 같은 용량이지만 브랜드가 다른 상품은 뭐야	SRC2
동일 개수 동일 용량이지만 다른 브랜드의 상품은 뭐야	SRC2
동일 개수와 동일 용량의 상품은 뭐야	SRC2
동일 개수와 동일 용량의 상품은 뭐가 있지?	SRC2
같은 개수와 같은 용량의 상품은 뭐가 있지?	SRC2
이것과 같은 개수에 같은 용량이지만 다른 브랜드의 상품은 뭐가 있지?	SRC2
다른 브랜드의 상품은 뭐가 있어?	SRC2
브랜드만 다른 상품은 뭐야?	SRC2
다른 조건은 동일하지만 브랜드만 다른 상품은 뭐가 있어?	SRC2
브랜드가 다른 상품 검색해줘	SRC2
브랜드만 다른 상품 찾아줘	SRC2
브랜드만 다른 상품 검색해줘	SRC2
다 동일하지만 브랜드만 다른 상품은?	SRC2
모두 동일하지만 브랜드만 다른 상품은 뭐가 있어?	SRC2
모두 동일하지만 브랜드만 다른 상품은 뭐야?	SRC2
모두 동일하지만 브랜드만 다른 상품 찾아줘	SRC2
동일하지만 브랜드만 다른 상품 찾아줘	SRC2
브랜드가 다른 상품은 뭐가 있어?	SRC2
동일 개수 동일 용량이지만 브랜드만 다른 상품은 뭐야?	SRC2
브랜드만 다른 상품이 뭔지 궁금해	SRC2
브랜드가 다르지만 같은 개수의 같은 용량의 상품을 검색해줘	SRC2
동일 개수의 같은 브랜드 찾아줘	SRC3
같은 개수의 동일 브랜드 검색해줘	SRC3
이거랑 같은 개수 같은 브랜드 검색해줘	SRC3
이 상품이랑 같은 브랜드의 같은 개수 검색해줘	SRC3
이 상품이랑 동일 브랜드의 동일 개수 상품 검색해줘	SRC3
동일 브랜드 동일 개수 상품 찾아줘	SRC3
동일 브랜드 개수 상품 검색해줘	SRC3
같은 브랜드 개수 찾아줘	SRC3
동일 브랜드 개수 찾아줘	SRC3
같은 브랜드 개수 검색해줘	SRC3
동일 브랜드 개수 상품 찾아줘	SRC3
동일 브랜드 개수이지만 다른 용량의 상품 찾아줘	SRC3
다른 용량 동일 브랜드 같은 개수 상품 찾아줘	SRC3
다른 용량이지만 동일 브랜드의 동일 개수의 상품 찾아줘	SRC3
다른 용량이고 같은 브랜드의 같은 개수의 상품을 찾아줘	SRC3
같은 브랜드 다른 용량 동일 개수의 상품 찾아줘	SRC3
용량이 다르지만 같은 브랜드 개수 상품 찾아줘	SRC3
용량이 다르지만 동일 브랜드 개수 상품 검색해줘	SRC3
용량이 다르지만 동일 브랜드 개수 상품은 뭐야?	SRC3
동일 브랜드에 같은 개수이지만 용량이 다른 상품은 뭐야	SRC3
동일 브랜드 동일 개수이지만 다른 용량의 상품은 뭐야	SRC3
동일 브랜드와 동일 개수의 상품은 뭐야	SRC3
동일 브랜드와 동일 개수의 상품은 뭐가 있지?	SRC3
같은 브랜드와 같은 개수의 상품은 뭐가 있지?	SRC3
이것과 같은 브랜드에 같은 개수이지만 다른 용량의 상품은 뭐가 있지?	SRC3
다른 용량의 상품은 뭐가 있어?	SRC3
용량만 다른 상품은 뭐야?	SRC3
다른 조건은 동일하지만 용량만 다른 상품은 뭐가 있어?	SRC3
용량이 다른 상품 검색해줘	SRC3
용량만 다른 상품 찾아줘	SRC3
용량만 다른 상품 검색해줘	SRC3
다 동일하지만 용량만 다른 상품은?	SRC3
모두 동일하지만 용량만 다른 상품은 뭐가 있어?	SRC3
모두 동일하지만 용량만 다른 상품은 뭐야?	SRC3
모두 동일하지만 용량만 다른 상품 찾아줘	SRC3
동일하지만 용량만 다른 상품 찾아줘	SRC3
용량이 다른 상품은 뭐가 있어?	SRC3
동일 브랜드 동일 개수이지만 용량만 다른 상품은 뭐야?	SRC3
용량만 다른 상품이 뭔지 궁금해	SRC3
용량이 다르지만 같은 브랜드의 같은 개수의 상품을 검색해줘	SRC3
