몇 개 짜리야?	WTR1
몇 개 들었어?	WTR1
몇 통 들었어?	WTR1
수량은 얼마야?	WTR1
수량 알려줘	WTR1
수량은?	WTR1
얼마나 들었어?	WTR1
몇 개나 들었어?	WTR1
몇 통이나 들었어?	WTR1
수량 알고 싶어	WTR1
몇 통인지 알려줘	WTR1
몇 개인지 알려줘	WTR1
몇 개짜리인지 알려줘	WTR1
몇 개짜리인지 알고 싶어	WTR1
몇 통인지 알고 싶어	WTR1
수량에 대해 알고 싶어	WTR1
수량 알려줘	WTR1
몇 개 들었는지 궁금해	WTR1
몇 개 들었는지 알고 싶어	WTR1
몇 개나 들었는지 궁금해	WTR1
몇 개나 들었는지 알려줘	WTR1
몇 통이나 들었는지 알려줘	WTR1
몇 통이나 들었는지 알고 싶어	WTR1
몇 통이나 들었는지 궁금해	WTR1
몇 팩짜리야?	WTR1
몇 팩이야?	WTR1
수량이 어떻게 되지?	WTR1
생수 몇 개 짜리야?	WTR1
생수 몇 개 들었어?	WTR1
생수 몇 통 들었어?	WTR1
생수 수량은 얼마야?	WTR1
생수 수량 알려줘	WTR1
생수 수량은?	WTR1
생수 얼마나 들었어?	WTR1
생수 몇 개나 들었어?	WTR1
생수 몇 통이나 들었어?	WTR1
생수 수량 알고 싶어	WTR1
생수 몇 통인지 알려줘	WTR1
생수 몇 개인지 알려줘	WTR1
생수 몇 개짜리인지 알려줘	WTR1
생수 몇 개짜리인지 알고 싶어	WTR1
생수 몇 통인지 알고 싶어	WTR1
생수 수량에 대해 알고 싶어	WTR1
생수 수량 알려줘	WTR1
생수 몇 개 들었는지 궁금해	WTR1
생수 몇 개 들었는지 알고 싶어	WTR1
생수 몇 개나 들었는지 궁금해	WTR1
생수 몇 개나 들었는지 알려줘	WTR1
생수 몇 통이나 들었는지 알려줘	WTR1
생수 몇 통이나 들었는지 알고 싶어	WTR1
생수 몇 통이나 들었는지 궁금해	WTR1
생수 몇 팩짜리야?	WTR1
생수 몇 팩이야?	WTR1
생수 수량이 어떻게 되지?	WTR1
수원지는 어디야?	WTR2
생산지는 어디야?	WTR2
생산지에 대해 알려줘	WTR2
생산지 알려줘	WTR2
생산지 알고 싶어	WTR2
생산지 궁금해	WTR2
소재지는 어디야?	WTR2
소재지에 대해 알려줘	WTR2
소재지 알려줘	WTR2
소재지 알고 싶어	WTR2
소재지 궁금해	WTR2
소재가 어디야?	WTR2
소재에 대해 알려줘	WTR2
생수 수원지 알려줘	WTR2
생수 수원지 알고 싶어	WTR2
생수 수원지에 대해 알려줘	WTR2
생수 어디서 생산된 물이야?	WTR2
생수 수원지 궁금해	WTR2
생수 수원지는 어디야?	WTR2
생수 생산지는 어디야?	WTR2
생수 생산지에 대해 알려줘	WTR2
생수 생산지 알려줘	WTR2
생수 생산지 알고 싶어	WTR2
생수 생산지 궁금해	WTR2
생수 소재지는 어디야?	WTR2
생수 소재지에 대해 알려줘	WTR2
생수 소재지 알려줘	WTR2
생수 소재지 알고 싶어	WTR2
생수 소재지 궁금해	WTR2
생수 소재가 어디야?	WTR2
생수 소재에 대해 알려줘	WTR2
